



C  194,255,226
SO            ./textures/colorstone.xpm
WE ./textures/bluestone.xpm
S      ./textures/barrel.xpm
F 225,255,134
R 1024 768

NO ./textures/wood.xpm
EA ./textures/mossy.xpm
1111111111111111111111111111111111111111
   11 11100000011000000000000002200011
   1111111110000000002110000000100000111
11110000000111000002000000000000001111
10000220001101000000001110111000N0111
1110000001200000220000100000120000001
1000000000001000000000111011110202111      1
11111111111111111111111 10001102221
1                       10111100011
   111111               1000000001
   111111         1     1002002001      11
   111111         1111111000000001
   111111          122210002002001
   111111          111111000000001          111 
   111111               1111101111
   111111   1111        1002002001
   111111   1111        1000000001      
   111111   1111        1111111111 
