F 220,100,0
SO ./textures/colorstone.xpm
WE ./textures/bluestone.xpm
S ./textures/barrel.xpm
C 225,0,0
R 1024 768

NO ./textures/wood.xpm
EA ./textures/mossy.xpm


     1111111111111111111111111111111111111111
   1110000001100000000000000122001
1111111110000000002110000000100001
1000000000011100000200000000000101
1000022000110100000000111011100101111
1110000001200000220000100000120000001
10000000000010000000001110111100W1111      1
11111111111111111111111 1000111111
1                       1011111111
   111111               1000000001
   111111         1     1002002001      11
   111111         1111111000000001
   111111          1   10002002001
   111111          111111000000001          1 1
   111111               1111111111

   111111               1002002001
   111111               1000000001
   111111               1111111111



