R 1920 1080
NO ./path_to_the_north_texture
SO ./path_to_the_south_texture
WE ./path_to_the_west_texture
EA ./path_to_the_east_texture
S ./path_to_the_sprite_texture
F 220,100,0
C 225,30,0


    11111111   1111111111111
1111101000011   100000011111
120000100200111110000001
120000000000000000000001
100000100000001001111001 
100000100000001001 11001
100000120200001111111111
100000100000000000000001       1111
111111100000000000000001       1001 
  1000000100100000000001     111101
111111000000000000111001     111111
100111000000000000111001
1001110001111111101110011
1001100021      100110001
1001100001    111011000111
1001100001   11000110001
100110000111110000110001
100000000002000000000001
100011110000000000N00001
100011110000000000000001
100010000200020111111111
100000000220000111111
111111110000000000001111
  11 1 11111111111111111
