1 11111
1101001
1000011
10001
1000011
1111111
