R 640 480
NO ./textures/wood.xpm
SO ./textures/colorstone.xpm
WE ./textures/redbrick.xpm
EA ./textures/mossy.xpm
S ./textures/barrel.xpm
F 220,100,0
C 225,30,0


111111
122101
120001
1100N1
111111
111111
