

R 10000 10000
NO ./textures/colorstone.xpm


EA ./textures/greystone.xpm
WE ./textures/bluestone.xpm

S ./textures/barrel.xpm
F 220,255,255
C 225,30,23

SO ./textures/wood.xpm

    111111111111111111111111
    1111101000000000000000011111
   1111111110111002111111111111
  1111111110111110001111111111
  120000000000111110000001
  122222111120000000222221
  111111111110111111111111
            101           
  111111111110111111111111
  122222222210122222222221 
  122222222210122222222221
  122222222210122222222221 111 
  100000000000000000000001 101
  111111100000000000000001 101
    1000000100100000000001 111
  111111000000000000111001
  100111000000000000111001
  100111000111111110111001111111111111111111111111
  1001100021      10011000000000000000000000000001
1110011000011111111011000111111111111111111111100111
  1001100001   11000110001                    1001
  122110000111110000210001                    1001
  100000000002000000000001                    1001
  100011110000000000E00001111111111111111111111001
  100011110000000000210000000000000000000000000011
  100010000200020111111111011111111111111111111111
  100000000220000111111  1011
  11111111000000000000111111
     111111111111111111 111111111111111 1
