R 1024 768
NO ./textures/wood.xpm
SO ./textures/colorstone.xpm
WE ./textures/bluestone.xpm
EA ./textures/mossy.xpm
S ./textures/linus_sprite.xpm
F 184,113,39
C 51,198,227
1111111111111111111111111111111111111111111111111111111111
1E00000000000000000000000000000000000000000000000000000001
1111111111111111111111111211111111111111111111111111111111
1111111111111111111111111111111111111111111111111111111111
