

R 640 480
NO ./textures/colorstone.xpm


EA ./textures/redbrick.xpm
WE ./textures/mossy.xpm

S ./textures/linus_sprite.xpm
F 220,255,255
C 225,30,23

SO ./textures/wood.xpm

    11111111   11111111111
1111101000011111100000011111
120000100200111110000001
122222222222222222222221
122222222222222222222221 
122222222222222222222221
122222222222222222222221 111 
100000100000000000000001 101
111111100000000000000001 101
  1000000100100000000001 111
111111000000000000111001
100111000000000000111001
1001110001111111101110011
1001100021      100110001
1001100001    111011000111
1001100001   11000110001
122110000111110000210001
100000000002000000000001
100011110000000000W0000111
10001111000000000021000101
10001000020002011111111101
100000000220000111111  1011
11111111000000000000111111
1111 1 111111111111111 1
